10
10
B
O
S
X
BBBBBBBBBB
BOOOOOOSOB
BBBOOOOOBB
BOOOOOBOOB
BOBBBOOOBB
BBOOOBBOOX
BOBOOBOOOB
BOOOOOOBOB
BOOOOBOOOB
BBBBBBBBBB